back.png
000110000000000000000000000000110000000000000000000000
100000000100000000000000000000110000000000000000000000
010110010100000000000000000000110000000000000000000000
000110000000000000000000000000110000000000000000000000
100000000100000000000000000000110000000000000000000000
010110010100000000000000000000110000000000000000000000
000110000000000000000000000000110000000000000000000000
100000000100000000000000000000110000000000000000000000
010110010100000000000000000000110000000000000000000000
000110000000000000000000000000110000000000000000000000
100000000100000000000000000000110000000000000000000000
010110010100000000000000000000110000000000000000000000
010110010100000000000000000000110000000000000000000000
010110010100000000000000000000110000000000000000000000
