back.png
bloc.png
000010101010101010101010101010101010101010101010101010
020001010101010101010101010101010101010101010101010101
000010101010101010101010101010101010101010101010101010
101010101010101010101010101010101010101010101010101010
101010101010101010101010101010101010101010101010101010
101010101010101010101010101010101010101010101010101010
101010101010101010101010101010101010101010101010101010
101010101010101010101010101010101010101010101010101010
101010101010101010101010101010101010101010101010101010
101010101010101010101010101010101010101010101010101010
101010101010101010101010101010101010101010101010101010
010101010101010101010101010101010101010101010101010101
101010101010101010101010101010101010101010101010101010
010101010101010101010101010101010101010101010101010101
