back.png
bloc.png
101010101010101010101010101010101010101010101010101010
010101010101010101010101010101010101010101010101010101
101010101010101000000000000000000010101010101010101010
010101010101010100000000000000000001010101010101010101
101010101010101000000000000000000000101010101010101010
010101010101010100000000000000000001010101010101010101
101010101010101000000000000000000010101010101010101010
010101010101010100000000000000000001010101010101010101
101010101010101000000000000000000000101010101010101010
010101010101010100000000000000000001010101010101010101
000000000000000000000000000000000000101010101010101010
010101010101010101010101010101010101010101010101010101
101010101010101010101010101010101010101010101010101010
010101010101010101010101010101010101010101010101010101
