back.png
bloc.png
tower.png
000000000000000000000000000000000000000000000000000000000010000000000000
000000000000000000000000000000000000000000000000000000000101000000000000
000011110111100000000001110000000000000011111111000000001000100000000000
000010000000100000000011011000000000000010000001000000010000010000000000
000000001000000000000100000100000000000010000001111100100000001000000000
0000100000001000000001010101000000000000100000000000001110101110000000000
000011110111100000000100000100000000000000000000000001100000001100000000
000000000000000000000110001100000000000000000000000010010000010010000000
000000000000010000000000000000000000000000000000000100000000000001000000
000000000000010000000000000000000000000000000000001000000101000000100000
000000000000010000000000000000000011111111100000010000000010000000010000
000000000011111110000000000000000000000000100000011100011111110001110000
000000000000010000000000000000000000020000100000000000000000000000000000
000000000000010000000000000000000001000000100000001000000000000000000000
000000000000010000000100000000000001000000000000001000000000000000000000
000000011100000000000100000000000001111100000000001000000001000000000000
000010100100001000000100000000000000000000000000000000000001000000000000
000001000100001000000001110000000000000000000000000000000001000000000000
000000000111111000000000000000000001111111110000000000000001000000000000
000000000000000000000000000100000000000000000000000000000001000000000000
000000000000000000000000000100000100010100000100000000000001000000000000
000000000000000000000000000100000010001010001000000000000001000000000000
000000000010000000000100000100000001000000010000000111111111000000000000
000000000001000000001000000100000000111111100000000000000000000000000000
000000000000100000010000000100000000000000000000000000000000000000000000
000000000000010000100000000100000001001100110110011001100110000000000000
000000000000001001000000000100000000110011001001100110011001100000000000
000000000000000000000000000100000000000000000000000000000000000000000000
000000000000000000000000000100000000000000000000000000000000000000000000
