back.png
bloc.png
121010101010101010101010101010101010101010101010101010
010101010101010101010101010101010101010101010101010101
101010101010101010101010101010101010101010101010101010
101010101010101010101010101010101010101010101010101010
101010101010101010101010101010101010101010101010101010
101010101010101010101010101010101010101010101010101010
101010101010101010101010101010101010101010101010101010
101010101010101010101010101010101010101010101010101010
101010101010101010101010101010101010101010101010101010
101010101010101010101010101010101010101010101010101010
101010101010101010101010101010101010101010101010101010
010101010101010101010101010101010101010101010101010101
101010101010101010101010101010101010101010101010101010
010101010101010101010101010101010101010101010101010101
