back.png
bloc.png
000010101010101010101010101010101010101010101010101010
020000010101010101010101010101010101010101010101010101
000000101010101010101010101010101010101010101010101010
101010101010101010101010101010101010101010101010101010
101010101010101010101010101010101010101010101010101010
101010101010101010101010101010101010101010101010101010
101010101010101010101010101010101010101010101010101010
101010101010101010101010101010101010101010101010101010
101010101010101010101010101010101010101010101010101010
101010101010101010101010101010101010101010101010101010
101010101010101010101010101010101010101010101010101010
010101010101010101010101010101010101010101010101010101
101010101010101010101010101010101010101010101010101010
010101010101010101010101010101010101010101010101010101
